1,WALL,Usagi,
2,1, 8,1,15, 1,1,1
3,all
5, 1,1,1, 0,0,0, 0,0, 0, 0,1, 2,2,2, 1
5, 1,1,3, 0,0,0, 0,0, 0, 0,1, 2,2,2, 1
5, 1,1,5, 0,0,0, 0,0, 0, 0,1, 2,2,2, 1
5, 1,1,7, 0,0,0, 0,0, 0, 0,1, 2,2,2, 1
5, 1,1,9, 0,0,0, 0,0, 0, 0,1, 2,2,2, 1
5, 1,1,11, 0,0,0, 0,0, 0, 0,1, 2,2,2, 1
5, 1,1,13, 0,0,0, 0,0, 0, 0,1, 2,2,2, 1
5, 1,1,15, 0,0,0, 0,0, 0, 0,1, 2,2,2, 1

5, 10,2,10, 0,0,0, 0,0, 0, 0,0, 4,4,4, 1

5, 8,1,1, 0,0,0, 0,0, 2,0,0, 2,2,2, 2
6, 0,-8,0, 8,8,8, 0,1, 1
