1,BREAK SHOT,Usagi,
2,1, 15,1,15, 0
3,all

5, 1,1,1, 0,0,0, 0,0, 4, 0,1, 2,2,2, 1
5, 5,1,1, 0,0,0, 0,0, 4, 0,1, 2,2,2, 1
5, 9,1,1, 0,0,0, 0,0, 4, 0,1, 2,2,2, 2
5, 13,1,1, 0,0,0, 0,0, 4, 0,1, 2,2,2, 1

5, 3,1,3, 0,0,0, 0,0, 6, 0,2, 2,2,2, 1
5, 7,1,3, 0,0,0, 0,0, 6, 0,2, 2,2,2, 1
5, 11,1,3, 0,0,0, 0,0, 6, 0,2, 2,2,2, 1

5, 5,1,5, 0,0,0, 0,0, 8, 0,2, 2,2,2, 1
5, 9,1,5, 0,0,0, 0,0, 8, 0,2, 2,2,2, 1

5, 7,1,7, 0,0,0, 0,0, 10, 0,2, 2,2,2, 1

6, 0,-8,0, 8,8,8, 0,1, 1
