1,FRICTION SELECTION,Usagi,
2,1, 8,1,15, 0
3,all

5, 8,3,-4, 0,0,0, 0,0, 100, 0,0, 8,8,8, 2

4, 1,0,0
4, 1,0,1
4, 1,0,2
4, 1,0,3
4, 1,0,4
4, 1,0,5
4, 1,0,6
4, 1,0,7

5, 13,1,1, 0,0,0, 0,0, 0, 0,0, 2,2,2, 1
5, 13,1,3, 0,0,0, 0,0, 0, 0,0, 2,2,2, 1
5, 13,1,5, 0,0,0, 0,0, 0, 0,0, 2,2,2, 1
5, 13,1,7, 0,0,0, 0,0, 0, 0,0, 2,2,2, 1
5, 13,1,9, 0,0,0, 0,0, 0, 0,0, 2,2,2, 1
5, 13,1,11, 0,0,0, 0,0, 0, 0,0, 2,2,2, 1
5, 13,1,13, 0,0,0, 0,0, 0, 0,0, 2,2,2, 1
5, 13,1,15, 0,0,0, 0,0, 0, 0,0, 2,2,2, 1

5, 5,5,1, 0,0,0, 0,0, 0, 0,0, 2,2,2, 1
5, 11,5,1, 0,0,0, 0,0, 0, 0,0, 2,2,2, 1

5, 8,5,1, 0,0,0, 0,0, 0, 0,0, 2,2,2, 1
5, 8,3,3, 0,0,0, 0,0, 0, 0,0, 2,2,2, 1
5, 8,1,5, 0,0,0, 0,0, 0, 0,0, 2,2,2, 1

4, 1,1,1
5, 13,3,3, 0,0,0, 0,0, 0, 0,0, 2,2,2, 1

6, 0,4,-8, 8,8,8, 0,1, 1
6, 0,-9,-8, 8,8,8, 0,1, 1
6, 0,-8,0, 8,8,8, 0,1, 1
