1,SECOND POST,Usagi,
2,1, 13,11,15, 0
3,all

5, 1,1,9, 0,0,0, 0,0, 1, 0,0, 2,2,2, 2
5, 9,1,1, 0,0,0, 0,0, 1, 0,0, 2,2,2, 2

5, 13,9,15, 0,0,0, 0,0, 100, 0,1, 2,2,2, 1
5, 13,7,15, 0,0,0, 0,0, 100, 0,1, 2,2,2, 1
5, 13,5,15, 0,0,0, 0,0, 100, 0,1, 2,2,2, 1
5, 13,3,15, 0,0,0, 0,0, 100, 0,1, 2,2,2, 1
5, 13,1,15, 0,0,0, 0,0, 100, 0,1, 2,2,2, 1

4, 5,2,4
4, 6,2,4
4, 7,2,4

6, 0,-8,0, 8,8,8, 0,1, 1
