1,SHALLOW HOLE,Usagi,
2,1, 8,1,21, 0
3,all
5, 8,1,17, 0,0,0, 0,0, 100, 0,1, 2,2,2, 2
6, 0,-9,0, 8,8,8, 0,1, 1
6, -8,-8,0, 8,8,8, 0,1, 1
6, 0,-8,-8, 8,8,8, 0,1, 1
6, 8,-8,0, 8,8,8, 0,1, 1
6, 0,-8,8, 8,8,8, 0,1, 1

