1,BOUND,Usagi,
2,1, 4,1,1, 0
3,all

5, 4,23,3, 0,0,0, 0,0, 1, 0,1, 6,6,6, 1

6, 0,9,1, 1,1,1, 0,1, 1
6, 3,9,1, 1,1,1, 0,1, 1

5, 5,15,15, 0,0,0, 0,0, 1, 0,1, 2,2,2, 2

6, 0,4,5, 3,3,3, 0,1, 1

6, 0,-8,0, 8,8,8, 0,1.1, 1
