1,THIRD POST,Usagi,
2,1, 3,1,23, 0
3,all

5, 3,15,-11, 0,0,0, 0,0, 1, 0,1, 2,2,2, 2
6, 1,6,-6, 1,1,1, 0,1, 1

5, 3,13,-7, 0,0,0, 0,0, 1, 0,1, 2,2,2, 2
6, 1,5,-4, 1,1,1, 0,1, 1

5, 3,9,-3, 0,0,0, 0,0, 1, 0,1, 2,2,2, 2
6, 1,3,-2, 1,1,1, 0,1, 1

4, 0,0,3
4, 1,0,3
4, 2,0,3
5, 3,3,11, 0,0,0, 0,0, 10, 0,1, 6,6,6, 1

6, 0,-8,0, 8,8,8, 0,1, 1
6, 0,-8,8, 8,8,8, 0,1, 1
