1,FOURTH POST,Usagi,
2,1, 2,15,15, 0
3,all

6, 0,5,2, 2,2,2, 0,0, 1
6, 0,5,4, 2,2,2, 0,0, 1
6, 0,5,6, 2,2,2, 0,0, 1

6, 0,1,0, 2,2,2, 0,0, 1
6, 0,1,2, 2,2,2, 0,0, 1
6, 0,1,4, 2,2,2, 0,0, 1

6, 0,0,8, 2,2,2, 0,0, 1

6, 0,1,6, 1,1,1, 0,0, 1
6, 0,0,7, 1,1,1, 0,0, 1

6, 3,0,5, 1,1,1, 0,0, 1
6, 4,0,5, 1,1,1, 0,0, 1

6, 0,0,-8, 8,8,8, 0,0.1, 1
5, 15,1,15, 0,0,0, 0,0, 1, 0,1, 2,2,2, 2
6, 0,-8,0, 8,8,8, 0,0, 1
