1,ELEVATOR,Usagi,
2,1, 8,1,15, 0, 0, -15,-5,1, 15,11,15
3,all

5, -3,18,9, 0,0,0, 0,0, 100, 0,0, 4,4,4, 2

5, -5,15,9, 0,0,0, 0,0, 0, 0,0, 2,2,2, 1
5, -1,15,9, 0,0,0, 0,0, 0, 0,0, 2,2,2, 1
5, -3,15,9, 0,0,0, 0,0, 0, 0,0, 2,2,2, 1

5, 4,2,14, 0,0,0, 0,0, 10, 0,0, 4,4,4, 1

7, -3,3,7, 0,0,0, 0,0.05,0, 0,0, 6,6,6, 7
7, -3,-3,13, 0,0,0, 0,0.05,0, 0,0, 6,6,6, 7
7, -9,3,13, 0,0,0, 0,0.05,0, 0,0, 6,6,6, 7

6, 0,-8,0, 8,8,8, 0,0, 1
