1,WHICH,Usagi,
2,1, 9,3,7, 0, 0, -15,-2,1, 31,-1,15
3,all

5, 0,7,9, 0,0,0, 0,1, 100, 0,0, 12,12,12, 1
7, -6,-1,14, 0,0,0, 0,-0.03,-0.03, 0,0, 4,4,4, 7
7, -2,-2,14, 0,0,0, 0,-0.03,-0.03, 0,0, 4,4,4, 7
7, 2,-1,14, 0,0,0, 0,-0.03,-0.03, 0,0, 4,4,4, 7
7, 6,-2,14, 0,0,0, 0,-0.03,-0.03, 0,0, 4,4,4, 7

6, 4,0,3, 1,1,1, 0,0, 1


5, 1,1,-3, 0,0,0, 0,0, 100, 0,0, 2,2,2, 2
6, 0,-1,-2, 1,1,1, 0,0, 1

5, 1,1,21, 0,0,0, 0,0, 100, 0,0, 2,2,2, 2
6, 0,-1,10, 1,1,1, 0,0, 1
