1,INDY,Usagi,
2,1, -15,13,11, 0, 0, -5,1,-9, 7,21,11
3,one

5, -3,21,5, 0,0,0, 0.99,1, 1000, 0,1, 2,2,2, 2

5, -15,15,3, 0,0,0, 0,1, 10000, 0,1, 2,2,2, 3
5, -11,15,3, 0,0,0, 0,1, 10000, 0,1, 2,2,2, 3

4,-8,5,5
4,-8,4,5
4,-8,4,6

6, -8,0,-8, 4,4,4, 0,0, 1
6, -8,0,4, 4,4,4, 0,1, 1

6, -8,-8,-8, 8,8,8, 0,1, 1
6, 0,-8,-8, 8,8,8, 0,0, 1
6, -8,-8,0, 8,8,8, 0,1, 1
6, 0,-8,0, 8,8,8, 0,0, 1

6, -8,5,-4, 1,1,1, 100,0, 1
6, -8,4,-5, 1,1,1, 0,0, 1
6, -8,4,-4, 1,1,1, 0,0, 1

5, -17,11,-17, 0,0.707,0, 0,0, 0, 0,1, 6,6,6, 1

6, -4,2,-7, 2,2,2, 0,0, 1
6, -2,2,-7, 2,2,2, 0,0, 1
6, 0,2,-7, 2,2,2, 0,0, 1
6, 2,2,-7, 2,2,2, 0,0, 1

6, 4,0,-8, 4,4,4, 0,0, 1

5, 16,11,-13, 0,0.707,0, 0,0, 0, 0,1.5, 6,6,6, 1

6, 4,3,2, 1,1,1, 0,0, 1
6, 4,2,2, 1,1,1, 0,0, 1
6, 4,1,2, 1,1,1, 0,0, 1 
6, 4,0,2, 1,1,1, 0,0, 1

6, 5,4,2, 1,1,1, 0,0, 1
6, 6,4,2, 1,1,1, 0,0, 1

6, 7,3,2, 1,1,1, 0,0, 1
6, 7,2,2, 1,1,1, 0,0, 1
6, 7,1,2, 1,1,1, 0,0, 1 
6, 7,0,2, 1,1,1, 0,0, 1

6, 4,0,3, 1,1,1, 0,0, 1
6, 7,0,3, 1,1,1, 0,0, 1


6, 4,1,4, 1,1,1, 0,0, 3
6, 4,0,4, 1,1,1, 0,0, 3
6, 4,0,5, 1,1,1, 0,0, 3

6, 4,1,6, 1,1,1, 0,0, 1
6, 4,0,6, 1,1,1, 0,0, 1
6, 4,0,7, 1,1,1, 0,0, 1

5, 14,1,14, 0,0,0, 0,0, 1, 0,1, 2,2,2, 2


7, 1,21,-5, 0,0,0, -0.01,0,0, 0,0, 2,2,2, 7

6, -3,9,-3, 1,1,1, 0,0, 1
6, -2,9,-3, 1,1,1, 0,0, 1
6, -1,9,-3, 1,1,1, 0,0, 1
6, 0,9,-3, 1,1,1, 0,0, 1
6, 1,9,-3, 1,1,1, 0,0, 1
6, 2,9,-3, 1,1,1, 0,0, 1
6, 3,9,-3, 1,1,1, 0,0, 1

5, -5,23,-5, 0,0,0, 0.5,1, 100, 0,0, 2,2,2, 3
5, -5,21,-5, 0,0,0, 0.5,1, 100, 0,0, 2,2,2, 3
5, -3,21,-5, 0,0,0, 0.5,1, 100, 0,0, 2,2,2, 3

5, 7,23,-5, 0,0,0, 0.5,1, 100, 0,0, 2,2,2, 3
5, 7,21,-5, 0,0,0, 0.5,1, 100, 0,0, 2,2,2, 3
5, 5,21,-5, 0,0,0, 0.5,1, 100, 0,0, 2,2,2, 3

7, -3,1,5, 0,0,0, 0,0.05,0, 0,0, 2,2,2, 7

4, -2,3,3
4, -2,2,3
4, -2,2,4

4, -2,1,5
4, -2,0,5
4, -2,0,6


7, 3,3,11, 0,0,0, 0,0,-0.05, 0,0, 2,2,2, 7

4, 1,0,5
4, 1,1,6
4, 1,0,6
