1,PUSHER,Usagi,
2,1, 7,15,17, 0, 0, -4,-999,1, 7,999,15
3,all

5, -3,12,1, 0,0,0, 0,0, 100, 100,1, 2,2,2, 1
5, -3,12,3, 0,0,0, 0,0, 100, 100,1, 2,2,2, 1
5, -3,12,5, 0,0,0, 0,0, 100, 100,1, 2,2,2, 1
5, -3,12,7, 0,0,0, 0,0, 100, 100,1, 2,2,2, 1

5, 0,10,1, 0,0,0, 0,0, 100, 100,1, 2,2,2, 1
5, 0,10,3, 0,0,0, 0,0, 100, 100,1, 2,2,2, 2
5, 0,10,5, 0,0,0, 0,0, 100, 100,1, 2,2,2, 1
5, 0,10,7, 0,0,0, 0,0, 100, 100,1, 2,2,2, 1


5, 9,1,7, 0,0,0, 0,0, 100, 100,1, 2,2,2, 1
5, 6,1,9, 0,0,0, 0,0, 100, 100,1, 2,2,2, 1
5, 10,1,11, 0,0,0, 0,0, 100, 100,1, 2,2,2, 1
5, 6,1,12, 0,0,0, 0,0, 100, 100,1, 2,2,2, 1
5, 12,1,10, 0,0,0, 0,0, 100, 100,1, 2,2,2, 1
5, 15,1,12, 0,0,0, 0,0, 100, 100,1, 2,2,2, 1

7, -4,9,1, 0,0,0, 0.04,0,0, 100,0, 2,2,2, 7
7, -4,9,3, 0,0,0, 0.04,0,0, 100,0, 2,2,2, 7
7, -4,9,5, 0,0,0, 0.04,0,0, 100,0, 2,2,2, 7
7, -4,9,7, 0,0,0, 0.04,0,0, 100,0, 2,2,2, 7
7, -4,9,9, 0,0,0, 0.04,0,0, 100,0, 2,2,2, 7
7, -4,9,11, 0,0,0, 0.04,0,0, 100,0, 2,2,2, 7
7, -4,9,13, 0,0,0, 0.04,0,0, 100,0, 2,2,2, 7
7, -4,9,15, 0,0,0, 0.04,0,0, 100,0, 2,2,2, 7

7, -3,4,4, 0,0,0, 0.04,0,0, 0,0, 8,8,8, 7
7, -3,4,12, 0,0,0, 0.04,0,0, 0,0, 8,8,8, 7

6, 3,6,8, 1,1,1, 0,0, 1

6, 0,0,-8, 8,8,8, 100,0.2, 1
6, 0,-8,0, 8,8,8, 100,0.2, 1
